url:	http://africanstorybook.org/reader.php?id=7156&d=0&a=1
id:	7156
title:	Muti  Ula Wavonokisye Ndua Ya Ombalantu
author:	
artist:	
lang:	
level:	Read aloud
lic:	Creative Commons: Attribution 3.0
thumb:	http://africanstorybook.org/illustrations/covers/7156.png
desc:	Thaimi and her brother Angula have a favourite baobab tree that they like to visit. One day raiders come to the village and Thaimi has a clever plan to hide everyone and save them. Can a tree really save a village?

page_text:


images:


translations:

Ekegusii (Translation)	Omote  Oria Okonyete  Okenyoro Ki’Ombalantu	id=7154
English (Original)	The Tree That Saved the Village of Ombalantu	id=2716
English (Translation)	The Tree That Saved the Village of Ombalantu	id=2724
French (Translation)	L’Arbre Qui Sauva Le Village D’Ombalantu	id=12869
Kiswahili (Translation)	Mti Ulionusuru Kijiji Cha Ombalantu	id=7158
Luganda (Translation)	Omuti Ogwataasa Abantu B’Embuya	id=7159
Lugbarati (Translation)	Pati Enyati Olivu Niri Ma Azakoopi Ri	id=7160
Maa (Translation)	Olchaní Óítajeúó Iltúng'áná Lé Ombalantu	id=7148
Oluwanga (Translation)	Omusaala Kwaonia Litala Lia Namulungu (Ombalantu)	id=7161
